1 1 1 1 1 1 1 1 C C 1 1 1 1 1 1 1 1
1 0 0 0 0 0 0 2 0 0 2 0 0 0 0 2 0 1
1 0 1 0 4 1 0 1 0 0 2 3 3 5 0 2 0 1
1 0 2 0 2 0 0 0 0 0 2 0 0 2 0 2 0 1
1 0 2 3 6 0 1 0 0 4 6 0 1 6 0 2 0 1
1 0 2 0 0 4 3 3 3 1 0 0 0 0 1 6 0 1
1 0 2 0 4 1 0 0 0 0 0 0 0 0 0 0 0 1
1 0 1 0 2 0 0 1 3 3 1 0 0 0 4 1 0 1
C 0 0 0 2 0 0 2 8 9 2 0 0 1 6 0 0 C
C 0 0 4 1 0 0 2 A B 2 0 0 3 0 0 0 C
1 0 1 6 0 0 0 1 3 3 1 0 0 3 0 1 0 1
1 0 0 0 0 0 0 0 0 0 0 0 1 6 0 2 0 1
1 0 4 1 0 0 0 0 1 3 3 3 6 0 0 2 0 1
1 0 2 0 4 1 0 4 6 0 0 1 0 4 3 2 0 1
1 0 2 0 2 0 0 2 0 0 0 0 0 2 0 2 0 1
1 0 2 0 7 3 3 2 0 0 1 0 1 6 0 1 0 1
1 0 2 0 0 0 0 2 0 0 2 0 0 0 0 0 0 1
1 1 1 1 1 1 1 1 C C 1 1 1 1 1 1 1 1

